level: 1 
WWWWWWWWWWWWWWWWW
WP  B B W B  B EW
W WWW WBWBWWW W W
W B BB    W BB  W
W W WWW W WWW W W
W B     W   B B W
W WWW WWW W WWWWW
WBW      BB    BW
WWWWW W WWWBWWW W
WB         B  WBW
W W WWW WWW WWWBW
W   W W   B WBB W
W WWW W WWWBWWW W
WE   B  W  B B EW
WWWWWWWWWWWWWWWWW
