level: 1
WWWWWWWWWWWWWWWWW
WP BB B W   BB EW
W WWWBWWW W WWW W
W W W   WB  B   W
W W WWW WWW WWW W
W  B   B   B  BBW
W W W W WWW WWWWW
W B   B       W W
WWWBWWW WWWBWWW W
WB   B   BW WB  W
W WBWWWBWWW WWW W
W B  BW BB   B  W
W W W W WWWBWWW W
WE B    W      EW
WWWWWWWWWWWWWWWWW
