level: 3
WWWWWWWWWWWWWWWWW
WP   BB WB BB  EW
W WBWWWBWWW WWW W
W B  B BB  BB  BW
WBW W W WWW WWW W
WB BW  BB B  B BW
W W WWWBWWWBWWWWW
W B  BW B W  BB W
WWWBWWW W WWWBWBW
WBW B  B   BW   W
WBWBW WWWBWWW W W
W   B BBW   B WBW
W WWWBWWW WWWBW W
WE    BBWBB    EW
WWWWWWWWWWWWWWWWW
