level: 4
WWWWWWWWWWWWWWWWW
WP BB  BWB  BB EW
W WWWBWBWWW WWW W
WBW B B  B B  B W
WBWBWWW WWWBWWWBW
W B B WB BB WB BW
WBW WWWBWWW WWWWW
WB B  B  BWB BW W
WWW WBWWWBWWWBWBW
W BBW  BW B   BBW
WBW WWWBWWWBWWW W
WB BB B B   B B W
W WWWBWWWBWWW W W
WE B  B WBB  B EW
WWWWWWWWWWWWWWWWW
