level: 1 
WWWWWWWWWWWWWWWWW
WP     BWB  B  EW
W W W WWW WWW W W
W    BW   W BB  W
WBWWW W WWWBWWW W
W B W   W     B W
WBWWW W WWW WWWWW
WBW  B    B   WBW
WWW WWWBWWW WWW W
WBB   B  BB W   W
W WWW W WWWBWWW W
WBB  B B        W
W W W W WWW WWW W
WE    B WBB  B EW
WWWWWWWWWWWWWWWWW
