level: 1
WWWWWWWWWWWWWWWWW
WP  B B WBB  B EW
W WWWBWWW W WWW W
W B  BB    B  W W
W WBWWW W WWW WBW
W W W W         W
W WWW WWW WWW WWW
W      BB   W B W
WWWBWWWBW WBWWWBW
W         W     W
WBWWW WBWWW W WBW
W  B    W BB  BBW
W WWWBWWW W WWW W
WE   B  W B    EW
WWWWWWWWWWWWWWWWW
