level: 1 
WWWWWWWWWWWWWWWWW
WP    B W B    EW
W WBWWWBWWW WWW W
W   BBWB        W
W WWW W W WWWBWBW
W W    B   BW W W
W W W WWW W WWWWW
WBB     W W    BW
WWWBWWW WWW W W W
W  BB     B BB  W
W WWW WWWBW W WBW
W   W B  B  B B W
W WBW WWW WWWBW W
WE  B   W  B   EW
WWWWWWWWWWWWWWWWW
