level: 1 
WWWWWWWWWWWWWWWWW
WP     BWB     EW
W W W WWW WBWWW W
WBB BB  B  BW   W
W W WWW WWW W W W
W     W     B  BW
W WBWWWBW WBWWWWW
WBB W B    B  W W
WWW WWW WWW WWWBW
W    B BW B     W
W W WBW WWW WWW W
WBW B     W BB  W
W WWW WWW WWW W W
WE   B BW    B EW
WWWWWWWWWWWWWWWWW
