level: 1
WWWWWWWWWWWWWWWWW
WP      WB     EW
W W WWW WWW WWW W
W  B  W  B BB WBW
W WWW W WWW WWW W
W W B   W B W BBW
W W WBW WWW WWWWW
W    BB B       W
WWWWW WBW WWWBW W
WB BW BB  WB  BBW
WBWWW W W WBWWWBW
W    B B        W
W W WWW WWW WWW W
WE   B BW      EW
WWWWWWWWWWWWWWWWW
