level: 1 
WWWWWWWWWWWWWWWWW
WP    BBWB     EW
W W WWWBWWWBWWW W
W  B  W     WB  W
W WWW WWW W WWW W
W   B BB  B     W
WBWWWBWWW WBWWWWW
W  BW   W   BB BW
WWWWW W W WWW WBW
W W  B   BWBB   W
W WWW WWW W W W W
W   B      BB WBW
W W WBW WWW WWW W
WE   BB W      EW
WWWWWWWWWWWWWWWWW
