level: 1 
WWWWWWWWWWWWWWWWW
WP  B B W    B EW
W W WWW W WWW W W
W      BB B  BB W
WBWBWWW WWW WWW W
W    BB   W     W
W WWW WBWWW WWWWW
WBWB    BB B  B W
WWWWW WWW WWW W W
WB      W   WBW W
W WBW WBWWWBWWW W
W   WBW B B    BW
W W WWWBWWW WWW W
WE  B   W      EW
WWWWWWWWWWWWWWWWW
