level: 1 
WWWWWWWWWWWWWWWWW
WP B BB W      EW
W W WWW W WBWWW W
W W W       B  BW
WBW WWWBWWW W WBW
W  B   B   BB W W
W WWW W WWW WWWWW
W  B  B    BW BBW
WWWBWWW WWW WBW W
W B     B   B  BW
WBW WWWBW WWW W W
W B  BW W W   B W
W W WWW W W WWW W
WE      W    B EW
WWWWWWWWWWWWWWWWW
