level: 1
WWWWWWWWWWWWWWWWW
WP  B   W B    EW
W WWW W W WWWBW W
W WB      W   B W
W W WWW W WBWWW W
W   W WB   BB   W
W WBW WWW WWW WWW
W     BB B  B BBW
WWWWW WBW W WWW W
W   B   W B   BBW
W W WWW WWW WWWBW
W    B  B   WBW W
W W WWWBWBWWW W W
WE  B   W BB   EW
WWWWWWWWWWWWWWWWW
