level: 1 
WWWWWWWWWWWWWWWWW
WP     BW      EW
W WWWBW W WBWWW W
WB B B   B B    W
W WWW WWW W WWWBW
W     B   BB  B W
WBWBWBWWW W WWWWW
WBB   W   W   W W
WWW WWW W WBWWW W
W  BW B BB  W  BW
W WWW WWW WWW W W
WBW    BW B  B  W
W W WWW WWWBWWW W
WE     BW      EW
WWWWWWWWWWWWWWWWW
