level: 1 
WWWWWWWWWWWWWWWWW
WP   B  W  B   EW
W WWW WWW WWW W W
W   B W B   W   W
WBW W WWW W WWWBW
W W     B   B   W
W WWW W WWWBWWWWW
W    BB WBW BB  W
WWWWWBW W WWW W W
W   B B B BB   BW
W W WWWBWWW WWW W
W   WB        WBW
W WWW WWW WBW W W
WE B BB WB   B EW
WWWWWWWWWWWWWWWWW
