level: 1 
WWWWWWWWWWWWWWWWW
WP B    W B    EW
W W WWW WWW W W W
W B W   BB     BW
W W W W WWW WWW W
WB BB   WB   B  W
W WWWBW WWW WWWWW
W B       W   W W
WWW WWWBW WWW W W
W B     BB    B W
W WWW W WWWBW WBW
W W   WB B  W B W
W WBWWWBWWW WWW W
WE BB B WB  B  EW
WWWWWWWWWWWWWWWWW
