level: 3
WWWWWWWWWWWWWWWWW
WP    BBW B  B EW
W WWWBWWW WWWBW W
W B  B  B  BW W W
W WWW WBWWWBWWWBW
WBB W  B B  BB  W
WBWWWBW WWWBWWWWW
W BB BW  BB BB BW
WWW WWW WWW WWW W
WBWBB  BB WB   BW
W WBWWWBWWW W W W
WBB  B  WBB   B W
W WWWBWWW WWW W W
WE  B B WBB    EW
WWWWWWWWWWWWWWWWW
