level: 1
WWWWWWWWWWWWWWWWW
WP    B WB  B  EW
W WWW WWW W WWW W
W  B  W WBB   B W
WBWBWWW WWWBWWW W
WB         B    W
W WBWWW WWW WWWWW
W W W     B B  BW
WWW WWW WWW WWW W
W  B    BBW W   W
W WWW W WWW WWW W
W    B  B B BBW W
W WBWWWBWWW WBW W
WE B B  W  B   EW
WWWWWWWWWWWWWWWWW
