level: 2
WWWWWWWWWWWWWWWWW
WP  B B WBB    EW
W WWW W WWW WWW W
WBB   BB  B  BB W
WBWWW W WWWBWWW W
W       WBB    BW
W W WWWBWWWBWWWWW
WBW W B   W W BBW
WWWBWWWBWWW WWW W
W B  B  B   B WBW
WBWWW W WWW WWW W
W B   WBB  B   BW
W WWW W WWW W W W
WE B BB W B  B EW
WWWWWWWWWWWWWWWWW
