level: 1 
WWWWWWWWWWWWWWWWW
WP B  B W BB   EW
W WBWWW WWWBWWW W
W B B W      B BW
WBWWW W WWW WWW W
W      BW B     W
W WWWBW WWWBWWWWW
W B B  B    WBB W
WWWWW W WWW WWWBW
W   W  B    B  BW
W WBWWW WWW WWW W
WBWB      W   W W
W WWW W WWW WWW W
WE  BB  W B    EW
WWWWWWWWWWWWWWWWW
