level: 1 
WWWWWWWWWWWWWWWWW
WP  B   W    B EW
W WWW WWW W WWW W
WB BB  BWB    WBW
W W WWW WWWBWWWBW
W     W     WB  W
W W WWWBWWWBWWWWW
W  B     BWB B  W
WWWWWBW WWW WWW W
WB  W  B  B     W
W WWW W W WWW W W
W W  B    B  B  W
W W WWWBWWW WWW W
WE B B BWB   B EW
WWWWWWWWWWWWWWWWW
