level: 1 
WWWWWWWWWWWWWWWWW
WP  B B WB BB  EW
W W WWW WWW WWW W
W       W     BBW
W WBWWW WWW WWWBW
W BBW    B   BB W
W W W WBWWW WWWWW
W          BW WBW
WWWWW W WWW W W W
W BB   BB WBB   W
W W WWW WWW WWW W
WBW   W   B  B  W
W W WBWWW WBWWW W
WE    B W   B  EW
WWWWWWWWWWWWWWWWW
