level: 1 
WWWWWWWWWWWWWWWWW
WP  B  BW      EW
W WWW WBWWWBWWW W
W B   B  BW B WBW
W W W WWW WWW W W
WBB B W   B BB  W
W WWWBW W WWW WWW
W   W B    B    W
WWWWW WWW WWW W W
W B  B  B   B   W
WBWWW W WWW W W W
W W B   W B W B W
W WWWBW WBW WWW W
WE B  B W      EW
WWWWWWWWWWWWWWWWW
