level: 1 
WWWWWWWWWWWWWWWWW
WP      W      EW
W WWW W W W WWW W
WB B    B WB B  W
W WWW W WWW WWWBW
W  B   BB    B  W
W W WBWWW W WWWWW
WBW W  BB  B BW W
WWW WBWWW WWWBW W
W     W WB  W  BW
WBWWWBW W WBWWW W
W    BB    B  B W
W WWW WWW W WWW W
WE     BWB  B  EW
WWWWWWWWWWWWWWWWW
