level: 1
WWWWWWWWWWWWWWWWW
WP   B  W  B B EW
W W WWWBWWW W W W
W    B BB    B  W
WBWBW W WWW WWW W
W W   W W   W   W
W WWW W WWW WWWWW
W B      BW B  BW
WWWWWBWBWWW WWW W
W   W B   B   W W
W WWWBWWW WWWBW W
W      B B  BB BW
W W WWW WWW WWW W
WE  BB BW B B  EW
WWWWWWWWWWWWWWWWW
