level: 1 
WWWWWWWWWWWWWWWWW
WP  B   W      EW
W W WWW WWW WWW W
W W    B B BB   W
W W W WWW WWW WBW
W   WBW  BW B BBW
W WBW WWW WWWBWWW
W BB  BBW B W   W
WWWWW W WWW WWWBW
W  BB       BB  W
WBWWW WBW WWW W W
W   B   B B   W W
W WWW WBWWW WWW W
WE      W B    EW
WWWWWWWWWWWWWWWWW
