level: 1 
WWWWWWWWWWWWWWWWW
WP  B   W B B  EW
W WWW WBWWWBWWW W
WB   BW     B  BW
WBW WBW WWW WWW W
W W       W   W W
W W WWW W W WWWWW
W  B B  WB BB  BW
WWW WWWBWWWBWWW W
W    BB B   W   W
WBWWW WWW W W W W
WB  W    B B    W
W WWW WWW WWW W W
WE   BB WB   B EW
WWWWWWWWWWWWWWWWW
