level: 1
WWWWWWWWWWWWWWWWW
WP B    W  B B EW
W W WWW WWWBWWW W
W      BB     WBW
W W WBW WWW WWW W
W W  B BW      BW
WBW WWW W WWW WWW
WB BW     W  B  W
WWWWWBWWW WWW W W
WB B   B B  W B W
W WWW W WWW WWW W
WB   BWB  BB  B W
W W WWW WWW WWW W
WE BB   W    B EW
WWWWWWWWWWWWWWWWW
