level: 1 
WWWWWWWWWWWWWWWWW
WP B    W      EW
W WWW W WBW WWW W
W   B BB   B  B W
W W WWW WWW WWWBW
W B    B B   B  W
W WBW WWW W WWWWW
WBWB BB WBW   W W
WWWWW WWW WBWWWBW
W B  BB    BW B W
W WWW W WWW WWW W
W   W WB      BBW
W WWW W WWW WWW W
WE      W  BB  EW
WWWWWWWWWWWWWWWWW
