level: 1 
WWWWWWWWWWWWWWWWW
WP BB B W B  B EW
W W WBW WWW WWW W
W B  B   BB B   W
W WBWWW W WWW WBW
WBB  BB W    BW W
W W W WWW W WWWWW
W W WB  B B B  BW
WWWWW WWWBW WWW W
W     BB  BB B BW
W W WWW W WWW W W
W  B BW BBWBW B W
W WWW WBWWW WWW W
WE   B  W   BB EW
WWWWWWWWWWWWWWWWW
