level: 1 
WWWWWWWWWWWWWWWWW
WP  BB  W  B B EW
W WWW W W W WWW W
WB B    W    B BW
W W W WWW W WWW W
W W     B B    BW
W WWW WWWBW W WWW
W B B  B BW B   W
WWWWWBWWW WWWBW W
W   W W       B W
W W WWWBWWWBWWW W
W B   BB  BBW W W
W W WWW WWW W W W
WE   B  W BB   EW
WWWWWWWWWWWWWWWWW
