level: 5
WWWWWWWWWWWWWWWWW
WP B  BBW B BB EW
W W WBWWW WBWWW W
WBB B BBW WB  WBW
W WWW WWWBW WWWBW
W B  BW BB  BB  W
WBW WBWWW WBWWWWW
WBB W B B B WB  W
WWWBWWWBWBW WWWBW
W  BB  B BB  BB W
WBW WBWWW WWW WBW
WBW BB  BB  B BBW
W WWW WWW WWWBW W
WE   BB WB  BB EW
WWWWWWWWWWWWWWWWW
