level: 1 
WWWWWWWWWWWWWWWWW
WP  B  BW  B   EW
W WBWWW W W WWW W
W     W WBW B B W
W W WWW WWW WWW W
W BB       BB W W
W WWW W WWW WWWWW
WB  B       B  BW
WWWBW WBWWW WWW W
W W  BB   B  B  W
W W WWW WBWWW WBW
WB BW  B   BW   W
W WWW W WWW WWW W
WE B B  W   B  EW
WWWWWWWWWWWWWWWWW
