level: 1
WWWWWWWWWWWWWWWWW
WP     BW  B B EW
W WWW WWW W WWW W
WBW       W   W W
WBW WBW WWW WWW W
W     WB B B    W
W WBW W WWW WWWWW
WB B    B B   B W
WWWWW W WWW WWW W
W B     B    BB W
WBWWWBWBWWW WWW W
W  BW   W B WB BW
W W WWW WWW WWW W
WE B   BW B B  EW
WWWWWWWWWWWWWWWWW
