level: 1
WWWWWWWWWWWWWWWWW
WP    B W    B EW
W WBWWW WBWBWWW W
W W BBW     W   W
W W WWW WWW WWW W
W  B B BW    B  W
W W WWW WWW WWWWW
WB  BB   BW B WBW
WWWWWBW WWW WWW W
W B   B      B  W
W W WWWBWWWBWBW W
W   W           W
W W WWWBWWWBWWW W
WE   B BWB   B EW
WWWWWWWWWWWWWWWWW
