level: 1 
WWWWWWWWWWWWWWWWW
WP      W   B  EW
W W W WWW WWW W W
WB  B W   W    BW
W W WWW WWW WWWBW
W W BB  WBB WB  W
W W W WWWBW WWWWW
W   B  B  B BB  W
WWW W WBWWW WWW W
W   WBB  B B    W
W WWW W WWWBW W W
WB B B  B     W W
W W W WBWWW WWW W
WE    B W   BB EW
WWWWWWWWWWWWWWWWW
