level: 1
WWWWWWWWWWWWWWWWW
WP     BW B  B EW
W WWW WWW WBWWW W
W   W  BW     W W
W WBWWW WWW WWW W
WB     B     B  W
W WWW W WBWWW WWW
W   B   B  BWB  W
WWW WWW WWW WWW W
W WB B B  WB B  W
W W WWW W WWWBWBW
W BB  W  BB   B W
W WBW WWWBW WWW W
WE    B W B    EW
WWWWWWWWWWWWWWWWW
