level: 2
WWWWWWWWWWWWWWWWW
WP B B  W   BB EW
W W W WWW WWW W W
W  B BB W  B  B W
W W W WWW WBWWW W
WB  B  B BW W   W
W WWWBWBW W WWWWW
W     B B  B  B W
WWW W W WWW WWWBW
W W BB   B  B B W
WBWBW WBWWWBWWW W
W   W WB  BB  WBW
W WWWBW WWW WWW W
WE  B  BWB  BB EW
WWWWWWWWWWWWWWWWW
