level: 1 
WWWWWWWWWWWWWWWWW
WP      W      EW
W W W WWW WWWBW W
WBB  BWBW WB  W W
W WBWWW WWW WWW W
W  B  B  BB  B BW
W WWW W W WWWBWWW
W W B      BB   W
WWW W WWWBWWW WBW
WB  W    B B   BW
W W WWW WWW WWW W
W  B  BB    WB BW
W W W WWW WWW W W
WE B    WB     EW
WWWWWWWWWWWWWWWWW
