level: 1 
WWWWWWWWWWWWWWWWW
WP BB   WB B   EW
W WWW WWW W W W W
W B   B  BWB    W
W W WWW WBWWW W W
W WB BWBB   W   W
WBWBW W WWWBWWWWW
WB       B      W
WWW W W WWW WWW W
W B  B    B BB  W
W W WBW WWW WWW W
WB  W   W B B W W
W W W W WWW WWW W
WE     BW  B B EW
WWWWWWWWWWWWWWWWW
