level: 1 
WWWWWWWWWWWWWWWWW
WP     BWB     EW
W WWW W WWW WWW W
W B W W         W
W W WWWBWBW WWWBW
W W   BB  W   BBW
W WWW W W W WWWWW
W B BB  BB   BW W
WWWWWBW WWWBWWW W
W   B     B  B  W
W WWW WBW WWW W W
WB   BB WB BW B W
W WWW WWW WWW W W
WE   B  W  B   EW
WWWWWWWWWWWWWWWWW
