level: 4
WWWWWWWWWWWWWWWWW
WP  B BBW B  B EW
W W WWW WBWBWWW W
W  B B  B B BBW W
WBWBWWWBWWWBWWWBW
WBB B W  B  B BBW
W WWW WBWWWBWWWWW
WBWBWBB B W  BB W
WWW WBWWW WWWBWBW
W BB    WB BW   W
WBWBW WWWBWWWBW W
WB    BB  BB  BBW
W W WBW WWWBWWW W
WE B BB WBB  B EW
WWWWWWWWWWWWWWWWW
