level: 1 
WWWWWWWWWWWWWWWWW
WP  B   W      EW
W WBW WWWBWWW W W
WB BW B WB  WB  W
W WWW W WWWBWWW W
W    B        W W
W WWW WBWWW WWWWW
W W B       B   W
WWW WWWBW WBWWW W
W         WBB   W
W WBW W WWW WWWBW
W   B WB B   BB W
W W WBWWW WWWBW W
WE    BBW  BB  EW
WWWWWWWWWWWWWWWWW
